#########################################
#...#...#...#...#...#...#...#...#...#...#
#...#.*.#.*.#...#.*.#.*.#...#.*.#.*.#.*.#
#...#...#...#...#...#...#...#...#...#...#
#########################################
#...#...#...#...#...#...#...#...#...#...#
#.*.#...#.*.#...#...#...#.*.#.*.#.*.#.*.#
#...#...#...#...#...#...#...#...#...#...#
#########################################
#...#...#...#...#...#...#...#...#...#...#
#.*.#.*.#.*.#...#.*.#...#.*.#.*.#.*.#.*.#
#...#...#...#...#...#...#...#...#...#...#
#########################################
#...#...#...#...#...#...#...#...#...#...#
#.*.#.*.#...#.*.#.*.#...#...#.*.#.*.#.*.#
#...#...#...#...#...#...#...#...#...#...#
#########################################
#...#...#...#...#...#...#...#...#...#...#
#...#...#...#.*.#...#...#.*.#...#.*.#.*.#
#...#...#...#...#...#...#...#...#...#...#
#########################################
#...#...#...#...#...#...#...#...#...#...#
#.*.#.*.#...#...#.*.#.*.#...#.*.#.*.#...#
#...#...#...#...#...#...#...#...#...#...#
#########################################
#...#...#...#...#...#...#...#...#...#...#
#...#...#...#...#...#...#.*.#.*.#.*.#.*.#
#...#...#...#...#...#...#...#...#...#...#
#########################################
#...#...#...#...#...#...#...#...#...#...#
#.*.#.*.#...#...#...#.*.#.*.#...#.*.#.*.#
#...#...#...#...#...#...#...#...#...#...#
#########################################
#...#...#...#...#...#...#...#...#...#...#
#.*.#...#.*.#.*.#...#.*.#.*.#.*.#...#.*.#
#...#...#...#...#...#...#...#...#...#...#
#########################################
#...#...#...#...#...#...#...#...#...#...#
#...#.*.#.*.#...#.*.#.*.#...#...#...#...#
#...#...#...#...#...#...#...#...#...#...#
#########################################
