~~~~~~~~~~~~~~~~~~~~~~~~~~~~~~
~~~~~~~~~~~~~~~~~~~~~~~~~~~~~~
~~..~~......................~~
~~..~~......................~~
~~..~~..~~..~~..~~..~~~~~~~~~~
~~..~~..~~..~~..~~..~~~~~~~~~~
~~..~~..~~..........~~......~~
~~..~~..~~..........~~......~~
~~..~~~~~~~~~~~~~~~~~~..~~..~~
~~..~~~~~~~~~~~~~~~~~~..~~..~~
~~..~~..........~~..~~......~~
~~..~~..........~~..~~......~~
~~..~~~~~~..~~..~~..~~..~~..~~
~~..~~~~~~..~~..~~..~~..~~..~~
~~..........................~~
~~..........................~~
~~..~~..~~..~~..~~~~~~~~~~~~~~
~~..~~..~~..~~..~~~~~~~~~~~~~~
~~..~~..~~..................~~
~~..~~..~~..................~~
~~~~~~..~~~~~~~~~~..~~..~~..~~
~~~~~~..~~~~~~~~~~..~~..~~..~~
~~..........~~..............~~
~~..........~~..............~~
~~..~~..~~~~~~..~~~~~~..~~..~~
~~..~~..~~~~~~..~~~~~~..~~..~~
~~......................~~..~~
~~......................~~..~~
~~~~~~~~~~~~~~~~~~~~~~~~~~~~~~
~~~~~~~~~~~~~~~~~~~~~~~~~~~~~~
